*********************
*   *   *           *
* * * ***** ***** * *
* * * *   *     * * *
* * * *   *     * * *
* *   *   *     * * *
* *****   * *   * * *
*     *   * *   * * *
***** * *********** *
*                   *
*********************